111111111
100000C01
10P011111
10C010E01
100000001
111111111